19 19
###s....###########
#######...#########
#########......####
##############.####
##############.####
##############.####
##############.####
##############.####
##############.####
##############.####
##############.####
##############.####
##############.####
##############.####
##############.####
##############e####
###################
###################
###################
